16
################
#....#........P#
#......##......#
#.....#........#
#.....#........#
#......###.....#
##............##
##...........###
#......#......##
#.....####.....#
#.....###......#
###....###.....#
###....##......#
#............###
#E..........####
################