16
################
######........1#
###............#
##.....####....#
##....####.....#
##.....##...#..#
#...##.....##..#
#..####...###..#
#..###...####..#
#..##.....##...#
#..#...##.....##
#.....####....##
#....####.....##
#............###
#2........######
################